Team Marie:
Mohamed: Goed.
Kris: leuk gedaan met die fotos die later pas komen.
Gijs: loading screen is tof.
Marissa: leuk gedaan met die emoties.
Joen: die bubbel was gaaf
Coen: de film was letterlijk een triller
Leroy: ik weet niet precies wat er was gebeurt;
Wessel: Zieke app, die captions waren heel goed.
Reinier: Ik snap nu pas dat die mensen de tekst het denken. heel goed gedaan.
Giovanni: ....

Larisa
Kyle: leuke manier om door een website heen te tabben.
Heralt, werkt goed man, ziet er moeilijk uit maar het werkt.
Manouk, goed gedaan dat je eerst hoort wat je moet doen, niet dat je de hele tekst moet luisteren.
Stefan: cool gedaan met die contrasten
Jennifer: Ook slim gedaan met contrasten
Damian: Ook erg slim met die contrasten.
Thomas: Leuk gedaan met de screenreader battle.
Lars: nogmaals slim gedaan met de contrasten.
Robert: kort maar krachtig

Roger
Bas: Leuke mic.
Nick: leuke geluidjes.
Sjors: coole geluiden.
Tabish: lekker font
Max: Vet man, ik zag aan roger dat hij het echt tof vond.
Simone: lekkere voice reader, leuke plaatjes.
Ramone: grappig stem
lennart: ...
Wouter: Boe geroep grappig idee.

Marijn
Lien: handig
Marijn: ...
Mees: gaaf idee zo met die kleuren.
Daniel: handig
Kevin: ...
Marjolein: handig
Michel: ...
Peppe: coole layout
Randy: leuk andere thema dan de rest
Rik: gaaf zo met die animaties.


